#############################################################
#     #     #  #           #     # S              #      f   #
####  #  ####  ####  #  #  ####  ####  ####  #######  #  #  #
#  #  #  #           #  #  #  #  #        #        #  #  #  #
#  #  #  ####  ####  #######  #  #  ####  #############  ####
#           #  #           #     #  #     #                 #
#  ####  ####  #  #######  #  ####  #  #  #  #######  ####  #
#  #        #  #     #  #     #     #  #  #        #     #  #
####  ####  ####  ####  #  #  #  #############  #  #######  #
#     #     #     #  #     #              #     #     #     #
#######  ####  ####  #  #############  ##########  ####  #  #
#  #           #  #     #  #        #     #        #     #  #
#  #  #######  #  #  #  #  ####  #  #############  ####  #  #
#  #  #           #  #  #        #  #        #  #     #  #  #
#  ####  #############  ####  #######  #  #  #  #  ####  #  #
#  #        #           #  #           #  #  #     #     #  #
#  #  #  #  ####  ####  #  #  ####  ##########  ####  #  ####
#  #  #  #     #  #     #  #     #  #     #     #  #  #     #
#  ####  #  #  ##########  ####  ####  ####  ####  ####  #  #
#        #  #  #        #           #  #     #           #  #
####  #  ####  #######  #  #  #  #  #  ##########  ####  ####
#     #  #  #  #  #  #     #  #  #     #  #  #  #     #     #
#  #  ####  #  #  #  #  #############  #  #  #  #######  ####
#  #     #           #        #           #     #     #     #
#  #  ####  #  ##########  ####  ####  #  #  #  #  #######  #
#  #     #  #  #        #  #  #  #     #  #  #     #     #  #
#  ####  ####  #  #  #  #  #  #  #############  ####  ####  #
#  #     #        #  #     #        #        #        #  #  #
#  ####  ##########  ####  #######  ####  ####  ####  #  #  #
#  #     #     #  #  #        #  #  #  #  #     #  #        #
#  #  #######  #  #  ####  ####  ####  #  #  #  #  ####  #  #
#  #        #  #     #  #  #              #  #  #  #  #  #  #
#  ##########  ####  #  #  #############  #  #  #  #  ####  #
#  #  #     #        #     #  #     #        #           #  #
#  #  ####  #  ####  #######  ####  #  #  ####  #######  #  #
#     #  #     #     #  #     #  #     #  #  #  #     #  #  #
#  ####  #  #  ####  #  #  ####  #  #######  ####  ####  ####
#     #  #  #  #  #           #           #  #     #        #
#  ####  #  ####  #############  #######  #  ####  #######  #
#  # G                              #           #           #
#############################################################
